8 7 7 7 0 4 4 4 0 4 4 4 8 8 8 8 8 8 8 8
8 0 7 7 0 4 4 4 0 5 5 5 8 8 8 8 8 8 8 8
8 0 7 7 0 5 5 5 0 4 4 4 8 8 8 8 8 8 8 8
8 0 7 7 0 4 4 4 0 4 4 4 8 8 7 7 7 7 7 8
8 7 7 7 0 4 4 4 0 4 4 4 8 8 7 7 7 7 7 0
8 8 8 8 8 8 8 8 8 8 8 8 8 8 0 0 0 0 0 0
10 10 10 10 10 4 4 4 0 4 4 4 10 10 10 10 10 10 10 10
10 10 10 10 10 4 4 4 4 4 4 4 10 10 10 10 10 10 10 10
4 4 4 4 4 4 4 4 4 4 4 4 4 4 4 4 4 4 4 4
4 4 4 4 4 4 4 4 4 4 4 4 4 4 4 4 4 4 4 4
