08 08 08 00 04 04 04 04 04 04 04 04 04 04 04 04 04 04 04 04 04 04 04 04 04 04 04 04 04 04 04 04 04 04 04 04 04 04 04 04 04 04 04 04 04 10 10 10 10 10 10 11 11 11 11 11 11 08 08 08
08 08 08 00 04 04 04 04 04 04 04 04 04 04 04 04 04 04 04 04 04 04 04 04 04 04 04 04 04 04 04 04 04 04 04 04 04 04 04 04 04 04 04 04 04 10 10 10 10 10 10 11 11 11 11 11 11 08 08 08
08 08 08 00 04 04 04 04 04 04 04 04 04 04 04 04 04 04 04 04 04 04 04 04 04 04 04 04 04 04 04 04 04 04 04 04 04 04 04 04 04 04 04 04 04 10 10 10 10 10 10 11 11 11 11 11 11 08 08 08
08 08 08 00 04 04 04 04 04 04 04 04 04 04 04 04 04 04 04 04 04 04 04 04 04 04 04 04 04 04 04 04 04 04 04 04 04 04 04 04 04 04 04 04 04 10 10 10 10 10 10 11 11 11 11 11 11 08 08 08
08 08 08 00 04 04 04 04 04 04 04 04 04 04 04 04 04 04 04 04 04 04 04 04 04 04 04 04 04 04 04 04 04 04 04 04 04 04 04 04 04 04 04 04 04 10 10 10 10 10 10 11 11 11 11 11 11 08 08 08
08 08 08 00 04 04 04 04 04 04 04 04 04 04 04 04 04 04 04 04 04 04 04 04 04 04 04 04 04 04 04 04 04 04 04 04 04 04 04 04 04 04 04 04 04 10 10 10 10 10 10 11 11 11 11 11 08 08 08 08
08 11 11 11 11 11 11 11 11 11 11 04 04 04 04 04 04 04 04 04 04 04 04 04 04 04 04 04 04 04 04 04 04 04 04 04 04 04 04 04 04 04 04 04 04 10 10 10 10 10 10 11 11 11 08 08 08 00 00 00
08 11 11 11 11 11 11 11 11 11 11 04 04 04 04 04 04 04 04 04 04 04 04 04 04 04 04 04 04 04 04 04 04 04 04 04 04 04 04 04 04 04 04 04 04 10 10 10 10 10 11 11 11 08 08 00 00 00 00 00
08 11 11 11 11 11 11 11 11 11 11 04 04 04 04 04 04 04 04 04 04 04 04 04 04 04 04 04 04 04 04 04 04 04 04 04 04 04 04 04 04 04 04 04 04 07 07 07 07 07 11 11 08 08 00 00 00 00 00 00
08 11 11 11 11 11 11 11 11 11 11 02 02 02 02 02 02 02 02 02 02 02 02 02 02 02 02 02 02 02 02 02 02 02 02 02 02 04 04 04 04 04 04 04 04 07 07 07 07 11 11 08 08 00 00 00 00 00 00 00
08 08 08 08 08 08 08 08 11 11 11 02 02 02 02 02 02 02 02 02 02 02 02 02 02 02 02 02 02 02 02 02 02 02 02 02 02 02 04 04 04 04 04 04 04 07 07 07 11 11 11 08 00 00 00 00 00 00 00 00
08 08 08 08 08 08 08 08 11 11 11 02 02 02 02 02 02 02 02 02 02 02 02 02 02 02 02 02 02 02 02 02 02 02 02 02 02 02 04 04 04 04 04 04 04 07 07 07 11 11 08 08 00 00 00 00 00 00 00 00
08 08 08 08 08 08 08 08 11 11 11 02 02 02 02 02 02 02 02 02 02 02 02 02 02 02 02 02 02 02 02 02 02 02 02 02 02 02 04 04 04 04 04 04 04 10 10 11 11 11 08 00 00 00 00 00 00 00 00 00
08 08 08 08 08 08 08 08 11 11 11 02 02 02 02 02 02 02 02 02 02 02 02 02 02 02 02 02 02 02 02 02 02 02 02 02 02 02 04 04 04 04 04 04 04 10 10 11 11 08 08 00 00 00 00 00 00 00 00 00
08 08 08 08 08 08 08 08 11 11 11 11 11 02 02 02 02 02 02 02 02 02 02 02 02 02 02 02 02 02 02 02 02 02 02 02 02 02 04 04 04 04 04 04 04 10 10 11 11 08 00 00 00 00 00 00 00 00 00 00
08 08 08 08 11 11 11 11 11 11 11 11 11 11 11 02 02 02 02 07 07 07 02 02 02 02 02 02 02 02 02 02 02 02 02 02 02 02 04 04 04 06 04 04 04 10 10 11 11 08 00 00 00 00 00 00 00 00 00 00
08 08 08 08 11 11 11 11 11 11 11 11 11 11 11 11 11 02 07 07 07 07 07 02 02 02 02 02 02 02 02 02 02 02 02 02 02 02 04 04 04 04 04 04 04 10 10 11 11 08 08 00 00 00 00 00 00 00 00 00
08 08 08 08 11 11 11 11 11 11 11 11 11 11 11 11 11 11 07 07 07 07 07 02 02 02 02 02 02 02 02 02 02 02 02 02 02 02 04 04 04 06 04 04 04 10 10 11 11 11 08 00 00 00 00 00 00 00 00 00
11 11 11 11 11 11 11 11 11 11 11 11 11 11 11 11 11 11 07 07 07 07 07 02 02 02 07 07 07 02 02 02 02 02 02 02 02 02 04 04 04 04 04 04 04 07 07 07 11 11 08 08 00 00 00 00 00 00 00 00
04 04 04 04 04 04 11 11 11 11 11 11 11 11 11 11 11 11 11 07 07 07 11 02 02 07 07 07 07 07 02 02 02 07 07 07 02 02 04 04 04 06 04 04 04 07 07 07 11 11 11 08 08 00 00 00 00 00 00 00
04 04 04 04 04 04 11 11 11 11 11 11 11 11 11 11 11 11 11 11 11 11 11 11 11 07 07 07 07 07 02 02 07 07 07 07 07 02 04 04 04 04 04 04 04 07 07 07 07 11 11 11 08 08 00 00 00 00 00 00
04 04 04 04 04 04 11 11 11 11 11 11 08 08 08 11 11 11 11 11 11 11 11 11 11 07 07 07 07 07 02 02 07 07 07 07 07 02 04 04 04 06 04 04 04 07 07 07 07 07 11 11 11 08 08 08 00 00 00 00
04 04 04 04 04 04 11 11 11 11 11 08 08 08 08 08 11 11 11 11 11 11 11 11 11 11 07 07 07 11 11 11 07 07 07 07 07 11 11 11 11 11 11 11 11 11 11 11 11 11 11 11 11 11 11 08 08 08 08 08
04 04 04 04 04 04 11 11 11 11 11 08 08 08 08 08 11 11 11 11 11 11 11 11 11 11 11 11 11 11 11 11 11 07 07 07 11 11 11 11 11 11 11 11 11 11 11 11 11 11 11 11 11 11 11 11 11 08 08 08
04 04 04 04 04 04 11 11 11 11 11 08 08 08 08 08 11 11 11 11 11 11 11 11 11 11 11 11 11 11 11 11 11 11 11 11 11 11 11 11 11 11 11 11 11 11 11 11 11 11 11 11 11 11 11 11 11 08 08 08
08 08 08 08 08 08 11 11 11 11 11 08 08 08 08 11 11 11 11 11 11 11 11 11 11 11 11 11 11 11 11 11 11 11 11 11 11 11 11 11 11 11 11 11 11 11 11 11 11 11 11 11 11 11 11 11 11 08 08 08
08 08 08 08 08 08 11 11 11 11 11 08 08 08 08 11 11 11 11 11 11 11 11 11 11 11 11 11 11 11 11 11 11 11 11 11 11 11 11 11 11 11 11 11 11 11 11 11 11 11 11 11 11 11 11 11 11 08 08 08
08 08 08 08 08 08 08 08 08 08 08 08 08 08 08 08 08 08 08 08 08 08 08 08 08 08 08 08 08 08 08 08 08 08 08 08 08 08 04 04 04 06 04 04 04 08 08 08 08 08 08 08 08 08 08 08 08 08 08 08
08 08 08 08 08 08 08 08 08 08 08 08 08 08 08 08 08 08 08 08 08 08 08 08 08 08 08 08 08 08 08 08 08 08 08 08 08 08 04 04 04 04 04 04 04 08 08 08 08 08 08 08 08 08 08 08 08 08 08 08
08 08 08 08 08 08 08 08 08 08 08 08 08 08 08 08 08 08 08 08 08 08 08 08 08 08 08 08 08 08 08 08 08 08 08 08 08 08 04 04 04 06 04 04 04 08 08 08 08 08 08 08 08 08 08 08 08 08 08 08
